-
###############
###############
#°°°°°°°°°°°°°#
#---###-###---#
#---#-#-#-#---#
#-------------#
#-------------#
#-------------#
#-------------#
#-------------#
#-------------#
#----#---#----#
#----#---#----#
#-------------#
#######-#######
#######-#######
#-------------#
#------#------#
###############
